!name=Confused
!timer=180
________________
________________
_____###________
_____.S#________
IIIII..#________
I#F##.__________
#I.F.F__________
IIF#F#__####____
F#.F#I__.F.#____
FF#.F.F#FIF#____
_____I.#.I.F.#__
_____IF#F__.G#__
_____I.F.__###__
________________
________________
________________