!name=Fragile
!timer=90
!marble=glass
S...#...#......######........G
###.#.#.#.##.#.#...##.########
###.#.#.####.#.#.#....########
###...#.##...#.#.####.########
S...###....###...####........G