!name=Grey skull
!timer=30
____.......____
__.....G.....__
_............._
_..__.....__.._
..____...____..
_______._______
..____...____..
...__.._..__...
......___......
_.....___....._
___.........___
___....S....___
___.........___
___._._._._.___
___._._._._.___