!name=Tilt!
!timer=180
!tilt=19
________
_...____
_.S.____
_...____
_.....__
_.....__
_.....__
_###..__
____..__
____..__
____..__
____..._
____##._
______._
______._
______._
______._
______._
______._
______._
______._
______._
______._
______._
______G_
______#_
________