!name=Be careful
!timer=25
...............
.S.............
...............
____________...
____________...
____________...
...............
...............
...............
...____________
...____________
...____________
...............
.............G.
...............