!name=Act of balance
!timer=120
S.......
_______.
........
._______
._......
._.____.
._._....
..._G___