!name=Hi!
!timer=180
!tilt=-15,15
__________________
_..._____...__..._
_.S._____...__.G._
_..._____...__..._
_..._____...______
_..._____...__..._
_..._____...__..._
_..._____...__..._
_..._____...__..._
_..._____...__..._
_..._____...__..._
_..._____...__..._
_..._____...__..._
_...........__..._
_...........__..._
_..._____...__..._
_..._____...__..._
__________________