!name=Hase und Igel
!timer=15
##############################
#...........................G#
#.###################F########
#............................#
############################.#
#S...........................#
##############################