!name=Labyrinthic
!timer=60
###################
#S#...........#...#
#.#.#########.#.#.#
#.#.#....#....#.#.#
#.#.#.####.####.#.#
#.#...#..#....#.#.#
#.#.###.#####.#.#.#
#.#.......#...#.#.#
#.#######.#.###.#.#
#.........#...#.#.#
#.###########.#.#.#
#.#......#....#.#.#
#.######.#.####.#.#
#.#...........#.#.#
#.#.###########.#.#
#.#.............#.#
#.###############.#
#...............#G#
###################