!name=Small
!timer=50
!marble=rubber
!marble_size=0.3
_______________
____S__________
____.#_#_#_____
____M....______
___#####.#_____
____...#.______
____.G.#.#_____
____II.#.______
__#....#.#_____
___.####.______
__#......#_____
__########_____
_______________
_______________
_______________