!name=Run Forest
!timer=50
#####################
#.........S.........#
#.#################.#
#.#...............#.#
#.#.######.######.#.#
#.#.#...........#.#.#
#.#.#.#########.#.#.#
#.#.#.#.......#.#.#.#
#.#.#.#.##.##.#.#.#.#
#.#.#.#.#...#.#.#.#.#
#.#.#.#.#.G.#.#.#.#.#
#.#.#.#.#...#.#.#.#.#
#.#.#.#.#####.#.#.#.#
#.#.#.#.......#.#.#.#
#.#.#.####.####.#.#.#
#.#.#...........#.#.#
#.#.#############.#.#
#.#...............#.#
#.########.########.#
#...................#
#####################