!name=Dice!
!timer=180
!tilt=11,10
!marble=dice
_______________
_______________
_______________
_______________
_......_____...
_.......___....
_........_.....
_.S..........G.
_........_.....
_.......___....
_......_____...
_______________
_______________
_______________
_______________