!name=Look and see 2
!timer=180
_____________
_..._._.V.V._
_.S.___V___V_
_..MV.V._._._
___________V_
_._._._._._._
___________V_
_._._.V.V.V._
_____V_______
_._._._._..._
_____V___.G._
_._._.V.V..._
_____________