!name=Born Slippy
!timer=180
!tilt=2,0
!mode=drunk
...............____________
.S.............____________
...............____________
____________...____________
____________...____________
____________...____________
____________...____________
____________...____________
____________...............
____________.............G.
____________...............