!name=Complex
!timer=120
####################
#S......#...#....#G#
#.#####.#.#.#.##.#.#
#.#.....#.#.#.##.#.#
#.#.##I##.#.#..#.#.#
#.#.#.....#.#..#.#.#
#.#...#####.##.#.#.#
#.I.#.#......#.#.#.#
#####.#.MMMM.F.#.#.#
#.....#.MMMM.#.#.#.#
#I#####.MMMM.#.#.#.#
#.......MMMM.#.#.#.#
#######......#.#.#.#
#.....########.#.#.#
#.###..........#.#.#
#.#.############.#.#
#.#..............#.#
#I#F##############.#
#..................#
####################