!name=Born to roll
!timer=90
##############################
#S...........................#
#............................#
#............................#
#............................#
#............................#
#............................#
#............................#
#............................#
#............................#
#............................#
#............................#
#............................#
#............................#
#............................#
#............................#
#............................#
#............................#
#............................#
#............................#
#............................#
#............................#
#............................#
#............................#
#............................#
#............................#
#............................#
#..........................G.#
#............................#
##############################